111111111111111111111111111
1P00000000000000000000000E1
101111111111111111111111101
1000000010C0100000000000001
111111111111111111111111111
1C0010000000000000000000001
111111111111111111111111111
