1111111111111111111111111
1P000000000000000000000E1
1011111011111111011111011
1000001010000010010000011
1111101010111011010111111
1C000001000100000100000C1
1011111011111011111011111
1000001000000010000000001
11111111111111111111111111
