1111111111111111111111111111111
1C000000000000000000000000000E1
1000000000000000000000000000001
1000000000000000000000000000001
1000000000000000000000000000001
1000000000000000000000000000001
1000000000000000000000000000001
100000000000000C000000000000001
1000000000000000000000000000001
1000000000000000000000000000001
1000000000000000000000000000001
1000000000000000000000000000001
1000000000000000000000000000001
1000000000000000000000000000001
1000000000000000000000000000001
1000000000000000000000000000001
1000000000001000000000000000001
100000000001P100000000000000001
1000000000001000000000000000001
1C00000000000000000000000000001
1000000000000000C00000000000001
1000000000000000000000000000001
1000000000000000000000000000001
1C000000000000000000000000000C1
1111111111111111111111111111111
