111111111111111111111111111
1P00000000000000000000000E1
100011111111111111111100001
100000000000000000000000001
111110011111111111111111001
1C0000000000000000000000001
111111111111111111111111111
