1111111111111111111111111
1000000P0000P0000000000E1
1011111011111111011111011
1000001010000010010000011
1111101010111011010111111
1C000001000100000100000C1
1011111011111011111011111
1000001000P00010000000001
1111111111111111111111111
