1111111111111111111111111
1P000000000000000000000E1
1011111011111111011111011
1000001010000010010000011
11111010101110110101111
1C000001000100000100000C1
1011111011111011111011111111
10000010000000100000011
1111111111111111111111111
