11111
1C001
10001
1C0E1
11111
