1111111111111111111111111111111111
1P000000000000000000000000000000E1
1011111111111111111111111111111001
1C000000000000000000000000000001C1
1111111111111111111111111111111111
