1111111111
1P000000E1
1000111001
1C010000C1
1010101011
1C00010001
1000010001
1111111111
