11111111111111111111111111111111111111111111111111111111111111111111111111111111
10000000000000000000000000000000000000000000000000000000000000000000000000000001
10P01111110111111011111101111110111111011111101111110111111011111101111110111101
10010000000001000000000100000000010000000001000000000100000000010000000001000C01
10010000000001000000000100000000010000000001000000000100000000010000000001000001
10000011100000000000000000000000110000000000000000000000000000000000000000000001
100100000000010000000001000000001100000000010C0000000100000000010000000001000001
100100000000C1000000000100000011110000000001000000000100000000010000000001000001
10111111111111111011111101111111111111011111101111110111111011111101111111111101
100100000000010000000001000000111100000000010000C0000100000000010000000001000001
10000000000000000000000000000000000000001110000000000000000000C00000000000000001
1001000000000100000000010000000001000000111100000C000100000000010000000001000001
10010000000001000000000100000000010011100001000000000100000000010000000001000001
10000000000000000000000000000000000000000000000000111000000000111100000000000001
10111111110111111011111101111110111111011111101111111111111011111101111111111101
10010000000001000000000100000000010000000001000000000100000000010000000C01000001
10010000000001000000000100000000010000000001000000000100000000010011111001000001
100100000C00010000000001000000C0010000000001000000000100000011110011111001C00001
100000000000000000000000000000011000000000000000000000000000111100011C0000000001
10010000000001000000000100000000010000000001000000000100000011110001100001000001
10111111110111111011111101111110111111011111101111110111111011111101111111111101
10000000000000000000000000000000000000000000000000000000000001111000000000000001
10010000000001000000000100000000010000000001000000000100000001111000000001000001
10010000000001000000000100000000010000000001000000000100000000010000000001000001
10010000000001000000000100000000010000111001000000000100000000010000000001000001
10010000000001000000000100000000010000000001000000000100000000010000000001000001
10101111110111111011111101111111111111011111101111110111111011111101111110111101
1001000000000101111000010000000001000000000100000C000100000000010000000001000001
10010000000001011110000100000000010000000001000000000100000000010000000001000001
10000000000000000000000000000000000000000000000000000000000000000000000000000001
10010000000001000C00000100000000010000000001000000000100000000010000C00001000001
10010000000001000000000100000000010000000001000000000100000000010000000001000001
10111111110111111011111101111110111111011111101111110111111011111101111111111101
10011110000001000000000100000000010000000001000000000100000000010000000001000001
10011110000000000000000000000000000000000000000000000000000000000000000000000001
10010000000001000000000101100000010000000001000000000100000000010000000001000001
100100000000010000000001011000000100000000010000000001000000000100000C0001000001
10000000000000000011000C01100000000000000000000000000000000000000000000000000001
10111111110111111011111101111111111111011111101111110111111011111101111111111101
10011100000001000000000100011111110000001111000000000100000000010000000001000001
10011100000001000000000100011111110000001111000000000100000000010000000001000001
10010000000111110000000111111000010011111001000000000100000000111100000001000001
10000000000111110000000011100000000000000000000000000000000000111100000000000001
10010000000001000111100111110000010000000001000000000100000000111100000001111101
10111111110111111011111111111110111111011111101111110111111011111101111111111101
10000000000000000000000111110000000001100000000000000000000000000000000000000001
10010000000001000000000100000000010001100001000000000100000000010000000111111001
10010000000001000000000100000000010001100C01000000000100000000010000000111100001
1001000000000100000000010000000001000000000100000000010000000001C000000001000001
10010000000001000000000100000000010000000001000000000100000000010000000001000001
10101111110111111011111101111110111111011111101111110111111111111101111110111101
100100000000010000C0000100000000010000000001001100000100011111010000000001111101
10010000000001000000000100000000010000000001000000000100011111010000000001111101
10000000000000000000000000000000000000000000000000000000000000000000000000000001
1001111100C001000000000100000000010000000001111000000100000000010000000001000001
100100000000010000000001000000000100000000011110000001000000000100C0000001000001
10111111111111111011111101111110111111011111101111110111111011111101111111111101
1001000000000100000000010000000011111000C001000000000100C00000010000000001000001
10000000000000000000000000000000000000000C00000000000000000000000000000000000001
10010000000001000000000100000000010000000001000000000100000000010000000001000001
10C10000000001000000000100000000010000000001000000000100000000010000000001000001
10000000000000000000000000000000000000000000000000000000000000000000000000000E01
10000000000000000000000000000000000000000000000000000000000000000000000000000001
11111111111111111111111111111111111111111111111111111111111111111111111111111111
