111111111111111111111111111111
1P0000000000000111111111111111
1011111110111100000000000000E1
1C0000000010000001111111111111
111111111011111111000000000001
1C0000000000000000000000000001
111111111111111111111111111111
